##########
#S#......#
#.#.####.#
#.#....#.#
#.####.#.#
#......#.#
####.#####
#E.......#
##########
